1 1
EEEEEEEEEE
EDDEBBBEEE
BBBEEEEEEE
BBEEEEEEEE
EEEEEEEEEE
EDEEEBBBBB
EEEEEEEEED
EEDBBBBEEE
EEEEEDEEEE
EEEEEEEEED